10 20
####################
@+.#................
+##...##.##########.
.##.####.###%.####..
.##.####.###.>#####.
.##+####.####.#####.
+##%####.####o#####.
....####.####.....+.
########.########.o.
########%###########
