10 20
####################
@####>#########%####
.####.#########.####
...oo...%..o........
...+o......o........
###.o########+######
.......%o%+.........
####################
####################
####################
