6 10
@...o.....
....+.%...
o#########
........%#
+#########
.........>
